Orth	Phon
ހ	h
ށ	ʂ
ނ	n̪
ރ	ɾ
ބ	b
ޅ	ɭ
ކ	k
މ	m
ފ	f
ދ	d̪
ތ	t̪
ލ	l
ގ	ɡ
ޏ	ɲ
ސ	s̺
ޑ	ɖ
ޒ	z̺
ޓ	ʈ
ޔ	j
ޕ	p
ޖ	dʒ
ޗ	tʃ
ޘ	θ
ޙ	ħ
ޚ	x
ޛ	ð
ޜ	ʒ
ޝ	ʃ
ޞ	sˤ
ޟ	dˤ
ޠ	tˤ
ޡ	ðˤ
ޢ	ʕ
ޣ	ɣ
ޤ	q
ޥ	w
އަ	ə
އާ	əː
އި	i
އީ	iː
އު	u
އޫ	uː
އެ	e
އޭ	eː
އޮ	ɔ
އޯ	ɔː
